resources/firstmap.png
G 1 1
C 1 1
H 1 1
W 0 0
B 1 8

WWWWWWWWWWWWWWWWWWWWWWWWWWWWWWWW
WWWWWWWWWWWWWWWWWWWWWWWWWWWWWWWW
WWWWWWWWWWWWWWWWWWWWWWWWWWWWWWWW
WWWHGGGGGGGGGGGGGGGGGGGGGGGGHWWW
WWWGGGGGGGGGGGGGGGGGGGGGGGGGGWWW
WWWGGGGGGGGGGGGGBGGGGGGGGGGGGWWW
WWWGGGGGGWWWWWWWBWWWWWWGGGGGGWWW
WWWGGGGGGWWWWWWWBWWWWWWGGGGGGWWW
WWWGGGGGGWWWWWWWBWWWWWWGGGGGGWWW
WWWGGGGGGWWWWWGGBGWWWWWGGGGGGWWW
WWWGGGGGGWWWWWGGGGWWWWWGGGGGGWWW
WWWGGGGGGWWWWWGGGGWWWWWGGGGGGWWW
WWWGGGGGBBBBBBBGCGGGGGGGGGGGGWWW
WWWGGGGGGWWWWWGGGGWWWWWGGGGGGWWW
WWWGGGGGGWWWWWGGBGWWWWWGGGGGGWWW
WWWGGGGGGWWWWWWWBWWWWWWGGGGGGWWW
WWWGGGGGGWWWWWWWBWWWWWWGGGGGGWWW
WWWGGGGGGWWWWWWWBWWWWWWGGGGGGWWW
WWWGGGGGGGGGGGGGBGGGGGGGGGGGGWWW
WWWGGGGGGGGGGGGGGGGGGGGGGGGGGWWW
WWWHGGGGGGGGGGGGGGGGGGGGGGGGHWWW
WWWWWWWWWWWWWWWWWWWWWWWWWWWWWWWW
WWWWWWWWWWWWWWWWWWWWWWWWWWWWWWWW
WWWWWWWWWWWWWWWWWWWWWWWWWWWWWWWW
